10
10
start_money: 500

*^^^^^^~~~
.....^^^~~
.^^..~~~~~
......^^..
^^~~...^^.
~....^....
~~~...~^^.
~~...~~^..
...^^....~
.........@